area_azathor = {
    623 767 1301 1380 271 466 644 1382 953 1035 1454 872 607 525 849 833 170 1444 490 187 203 751 1428 1438 1392 429 203 1253 1344 951 832 913 1464 750 870 995 188 193 1169 1087 524 606 173 1447 428 1431 1044 1416 1310 788 1393 181 270 171 206 194 1453 956 994 186 180 1252 1459 1343 383 166 1441 1300 1168 1086 1216 932 1105 472 851 568 794 189 625 650 564 468 197 1362 952 1292 1383 447 1134 1271 1187 912 1042 960 1013 763 164 879 797 931 571 850 653 475 646 1127 1209 1384 622 565 1390 469 873 791 1207 1291 647 954 792 1103 948 1125 1104 562 1206 930 237 1361 1460 1012 1290 1129 541 1381 955 1037 445 1033 874 1011 929 848 652 766 796 624 768 542 446 1299 878 959 1041 1215 1010 1133 465 570 1210 1184 1036 1122 648 540 470 1204 444 566 1359 651 1128 1102 1294 474 1389 1214 847 1385 1268 958 1132 928 1040 1269 1298 1185 1135 1387 769 543 1293 790 1186 1270 765 
}

area_maskith = {
   877 795 539 621 860 1030 778 634 443 1124 1358 552 1032 1280 1196 1022 456 1101 859 778 1200 1284 1195 460 1375 1118 1026 944 196 205 1440 172 1430 1374 183 1462 1446 1439 1429 204 195 1289 1360 1205 165 1455 1461 182 1123 1445 861 779 635 556 1113 1370 777 1279 633 939 455 1376 1021 638 782 764 864 1201 431 1119 1027 945 461 620 865 527 563 645 454 846 858 632 550 776 868 927 949 1183 561 643 787 869 950 1267 786 642 560 464 1288 1379 867 785 871 789 641 559 463 1378 609 1287 1203 1121 1029 467 947 946 1202 753 1377 462 916 558 835 640 784 866 1456 1285 1009 1114 940 551 557 
}

area_oslor = {
    190 198 236 201 1442 298 487 386 1398 279 663 235 297 385 316 1053 280 1435 315 662 1052 1308 394 488 1465 178 1451 1399 1419 1436 1309 291 1449 395 273 184 489 1400 176 191 199 1448 387 1420 1302 1045 162 1433 1400 272 1457 230 169 290 378 310 167 168 177 926 174 1008 845 656 1182 1100 1422 1434 1357 1266 393 1307 1051 314 538 1357 1434 1046 442 388 200 384 661 1427 296 234 278 1397 486 660 382 295 1274 277 485 391 1305 659 1049 313 294 1050 233 1396 484 381 276 390 658 1306 380 1304 293 312 1048 232 275 1395 483 392 274 231 1394 1303 389 292 1047 311 379 657 655
}

area_kanlos = {
    1075 901 983 820 738 1331 417 594 1240 1156 1074 1421 982 900 819 737 1239 1330 1155 981 593 1073 899 736 511 416 592 818 1329 1072 510 415 980 1238 1154 898 1332 1450 1463 513 595 739 821 1228 1144 970 1062 726 807 581 975 889 409 499 1067 902 984 1158 1076 1242 1333 504 731 1318 1227 404 1149 1061 1143 821 410 894 1233 1324 813 732 976 1068 587 505 974 1150 1232 586 1323 418 514 1148 1066 406 1145 1063 971 809 1064 1071 973 810 728 1229 1320 583 501 893 596 740 811 729 892 1065 1231 1322 730 822 809 971 890 405 1319 972 891 727 500 582 507 412 1325 411 506 979 897 816 508 734 590 413 1327 1236 1152 978 1070 896 815 589 733 1326 1069 977 1235 1151 895 814 822 1153 1237 1328 584 1159 1077 985 903 585 503 1147 408 414 1243 1146 502 509 1230 407 1334 419 1321 591 735 817 515 597 741 823 904 516 420 986 1160 1078 1335 1244 812 1234 808 
}

area_ygkoh = {
    1172 1347 610 1256 432 1090 754 836 528 917 1091 1173 1350 435 531 757 839 920 999 613 1001 1093 919 838 1259 1175 756 1002 434 612 1257 1348 530 1094 755 611 1349 529 433 1260 837 1176 1258 918 1174 1092 1000 1351 1180 614 921 840 436 532 758 1095 1177 1003 761 843 1264 1098 1006 924 533 437 1261 1352 922 615 759 617 440 1004 1096 535 1178 1353 439 1262 1354 841 534 760 842 438 923 1005 1097 1179 1263 1354 536 618 762 1355 925 1166 844 619 537 829 992 1084 1250 910 441 1341 1356 1265 1181 1099 1007 1346 1255 752 1171 1089 834 997 608 915 1249 1340 604 522 1083 526 430 1165 991 909 426 748 830 911 747 746 1345 602 828 603 993 1085 1167 521 425 1251 520 1342 424 1254 914 1088 1339 996 427 1164 523 605 1170 1248 831 749 616
}

area_jinlo = {
    1245 1336 1161 598 1079 421 742 517 599 905 824 987 743 825 422 518 988 1080 1162 906 1246 1337 744 826 600 1082 990 908 1163 1081 827 1247 989 745 907 601 1338 519 423 998
}

area_rukmar = {
    1031 588 179 665 247 215 257 269 1443 337 192 368 706 699 202 353 185 317 336 304 1452 1458 1437 355 685 163
}

area_urshu = {
    888 969 806 725 580 403 498 1317 1226 1115 1197 1142 1023 941 1281 711 1372 457 553 360 691 342 262 1060 361 712 692 1371 218 240 942 709 689 668 677 371 358 340 1024 1116 249 260 217 1198 1282 688 239 667 708 676 370 357 1373 458 1369 339 259 554 1194 1278 1112 636 1020 775 938 857 631 780 862 943 1025 1277 1368 549 1193 1111 1025 1117 629 937 856 1019 453 805 774 630 548 452 1367 1192 1276 1110 1018 855 936 773 497 547 1365 450 1199 628 772 1190 451 1275 1366 854 546 1191 935 1109 1017 1108 1016 853 934 579 863 637 781 254 268 555 459 252 1283 375 672 682 347 244 268 256 222 367 258 674 246 684 698 338 639 224 377 783 687 717 369 1028 1120 238 1286 248 1425 325 356 480 707 228 627 771 545 1273 1189 449 1015 1107 933 852 770 626 544 1188 1363 1272 1014 1106 448 402 1313 1138 1056 1222 964 720 883 801 575 493 884 494 399 576 802 721 1316 887 968 724 1364 
}

area_jayaka = {
    376 1034 1126 223 1208 255 1141 1059 967 804 886 1057 1139 965 1314 1223 400 495 723 1225 1058 723 496 578 401 1315 1043 961 798 880 654 572 318 476 348 1391 305 477 1405 700 333 264 344 299 320 350 307 212 1406 696 715 365 345 680 671 266 1401 221 243 374 694 714 363 569 1388 473 1297 1213 876 1131 1039 211 686 213 1296 1212 957 1386 331 1130 1038 1295 210 471 225 567 875 649 793 1211 328 227 478 479 702 1424 324 301 332 319 349 327 306 226 701 323 335 300 1423 322 716 697 229 346 267 366 683 673 245 265 1402 1218 512 209 364 1140 1224 885 966 577 803 722 1137 882 800 492 574 719 397 1311 1054 1136 1466 1220 962 963 881 1055 799 718 573 491 396 253 1241 1157 664 681 354 705 695 398 1312 1221 372 690 710 303 678 326 675 669 1426 666 334 216 351 330 241 219 261 250 341 359 704 482 1408 309 352 1219 343 1404 362 713 263 693 302 703 373 251 220 242 679 670 208 214 481 1407 308 329 175 321 1403 207 1217
}

temp_sea_area = {
    1 2 3 4 5 6 7 8 9 10 11 12 13 14 15 16 17 18 19 20 21 22 23 24 25 26 27 28 29 30 31 32 33 34 35 36 37 38 39 40 41 42 43 44 45 46 47 48 49 50 51 52 53 54 55 56 57 58 59 60 61 62 63 64 65 66 67 68 69 70 71 72 73 74 75 76 77 78 79 80 81 82 83 84 85 86 87 88 89 90 91 92 93 94 95 96 97 98 99 100 101 102 103 104 105 106 107 108 109 110 111 112 113 114 116 117 118 119 120 122 123 124 125 126 128 129 130 131 132 134 135 136 137 138 140 141 142 143 144 145 146 147 148 149 150 151 152 153 154 155 156 157 158 159 160 161 
}